Name,TotalConfirmed,TotalDeaths,NewConfirmed,NewDeaths,survivors,Fatality_ratio,Region,Date
Afghanistan,183572,7731,165,2,175841,4.21,Other,2022-07-18T06:53:06.103Z
Albania,293917,3517,0,0,290400,1.2,Western_Europe,2022-07-18T06:53:06.103Z
Algeria,266445,6875,53,0,259570,2.58,Middle_East,2022-07-18T06:53:06.103Z
Andorra,44671,153,0,0,44518,0.34,Western_Europe,2022-07-18T06:53:06.103Z
Angola,101901,1909,0,0,99992,1.87,Other,2022-07-18T06:53:06.103Z
Antarctica,11,0,0,0,11,0.0,Other,2022-07-18T06:53:06.103Z
Antigua and Barbuda,8712,144,8,1,8568,1.65,Other,2022-07-18T06:53:06.103Z
Argentina,9465827,129202,39656,57,9336625,1.36,Other,2022-07-18T06:53:06.103Z
Armenia,423771,8629,0,0,415142,2.04,Other,2022-07-18T06:53:06.103Z
Australia,8734573,10659,81492,144,8723914,0.12,Other,2022-07-18T06:53:06.103Z
Austria,4618853,20163,0,0,4598690,0.44,Western_Europe,2022-07-18T06:53:06.103Z
Azerbaijan,793388,9717,0,0,783671,1.22,Other,2022-07-18T06:53:06.103Z
Bahamas,36354,822,0,0,35532,2.26,Other,2022-07-18T06:53:06.103Z
Bahrain,649401,1506,2706,1,647895,0.23,Other,2022-07-18T06:53:06.103Z
Bangladesh,1996340,29234,1907,9,1967106,1.46,Other,2022-07-18T06:53:06.103Z
Barbados,87463,479,244,0,86984,0.55,Other,2022-07-18T06:53:06.103Z
Belarus,994037,7118,0,0,986919,0.72,Other,2022-07-18T06:53:06.103Z
Belgium,4349050,32051,28943,36,4316999,0.74,Western_Europe,2022-07-18T06:53:06.103Z
Belize,65994,680,0,0,65314,1.03,Other,2022-07-18T06:53:06.103Z
Benin,27216,163,0,0,27053,0.6,Other,2022-07-18T06:53:06.103Z
Bhutan,59940,21,0,0,59919,0.04,Other,2022-07-18T06:53:06.103Z
Bolivia,968212,21979,7433,0,946233,2.27,Other,2022-07-18T06:53:06.103Z
Bosnia and Herzegovina,380749,15817,0,0,364932,4.15,Western_Europe,2022-07-18T06:53:06.103Z
Botswana,324841,2760,0,0,322081,0.85,Other,2022-07-18T06:53:06.103Z
Brazil,33250117,675090,173338,608,32575027,2.03,Other,2022-07-18T06:53:06.103Z
Brunei Darussalam,182950,225,0,0,182725,0.12,Other,2022-07-18T06:53:06.103Z
Bulgaria,1184429,37291,552,2,1147138,3.15,Western_Europe,2022-07-18T06:53:06.103Z
Burkina Faso,21128,387,0,0,20741,1.83,Other,2022-07-18T06:53:06.103Z
Burundi,43222,38,0,0,43184,0.09,Other,2022-07-18T06:53:06.103Z
Cambodia,136455,3056,34,0,133399,2.24,Other,2022-07-18T06:53:06.103Z
Cameroon,120068,1931,0,0,118137,1.61,Other,2022-07-18T06:53:06.103Z
Canada,3432951,38876,23756,1263,3394075,1.13,Other,2022-07-18T06:53:06.103Z
Cape Verde,61922,409,146,0,61513,0.66,Other,2022-07-18T06:53:06.103Z
Central African Republic,14712,113,0,0,14599,0.77,Other,2022-07-18T06:53:06.103Z
Chad,7427,193,0,0,7234,2.6,Other,2022-07-18T06:53:06.103Z
Chile,4122401,58990,18811,106,4063411,1.43,Other,2022-07-18T06:53:06.103Z
China,1515071,14663,7538,12,1500408,0.97,Other,2022-07-18T06:53:06.103Z
Colombia,6223497,140365,24649,163,6083132,2.26,Other,2022-07-18T06:53:06.103Z
Comoros,8209,160,0,0,8049,1.95,Other,2022-07-18T06:53:06.103Z
Congo (Brazzaville),24604,386,0,0,24218,1.57,Other,2022-07-18T06:53:06.103Z
Congo (Kinshasa),91737,1376,0,0,90361,1.5,Other,2022-07-18T06:53:06.103Z
Costa Rica,904934,8525,0,0,896409,0.94,Other,2022-07-18T06:53:06.103Z
Croatia,1168111,16156,2633,13,1151955,1.38,Western_Europe,2022-07-18T06:53:06.103Z
Cuba,1106798,8529,132,0,1098269,0.77,Other,2022-07-18T06:53:06.103Z
Cyprus,545896,1086,0,0,544810,0.2,Western_Europe,2022-07-18T06:53:06.103Z
Czech Republic,3952388,40352,585,2,3912036,1.02,Other,2022-07-18T06:53:06.103Z
CÃ´te d'Ivoire,84501,806,50,0,83695,0.95,Other,2022-07-18T06:53:06.103Z
Denmark,3250368,6600,0,0,3243768,0.2,Western_Europe,2022-07-18T06:53:06.103Z
Djibouti,15690,189,0,0,15501,1.2,Other,2022-07-18T06:53:06.103Z
Dominica,14852,68,0,0,14784,0.46,Other,2022-07-18T06:53:06.103Z
Dominican Republic,621047,4383,0,0,616664,0.71,Other,2022-07-18T06:53:06.103Z
Ecuador,927700,35769,0,0,891931,3.86,Other,2022-07-18T06:53:06.103Z
Egypt,515645,24725,0,0,490920,4.79,Middle_East,2022-07-18T06:53:06.103Z
El Salvador,180970,4174,0,3,176796,2.31,Other,2022-07-18T06:53:06.103Z
Equatorial Guinea,16584,183,0,0,16401,1.1,Other,2022-07-18T06:53:06.103Z
Eritrea,9864,103,12,0,9761,1.04,Other,2022-07-18T06:53:06.103Z
Estonia,585143,2608,0,0,582535,0.45,Western_Europe,2022-07-18T06:53:06.103Z
Ethiopia,491086,7561,161,0,483525,1.54,Other,2022-07-18T06:53:06.103Z
Fiji,66713,869,0,0,65844,1.3,Other,2022-07-18T06:53:06.103Z
Finland,1171034,5012,0,0,1166022,0.43,Western_Europe,2022-07-18T06:53:06.103Z
France,32881809,151454,0,0,32730355,0.46,Western_Europe,2022-07-18T06:53:06.103Z
Gabon,48289,306,0,0,47983,0.63,Other,2022-07-18T06:53:06.103Z
Gambia,12009,365,0,0,11644,3.04,Other,2022-07-18T06:53:06.103Z
Georgia,1667453,16847,0,0,1650606,1.01,Other,2022-07-18T06:53:06.103Z
Germany,29692989,142533,232740,249,29550456,0.48,Western_Europe,2022-07-18T06:53:06.103Z
Ghana,167215,1456,0,0,165759,0.87,Other,2022-07-18T06:53:06.103Z
Greece,3843142,30476,0,0,3812666,0.79,Western_Europe,2022-07-18T06:53:06.103Z
Grenada,18655,233,15,0,18422,1.25,Other,2022-07-18T06:53:06.103Z
Guatemala,984477,18822,6938,40,965655,1.91,Other,2022-07-18T06:53:06.103Z
Guinea,37358,445,0,0,36913,1.19,Other,2022-07-18T06:53:06.103Z
Guinea-Bissau,8400,171,0,0,8229,2.04,Other,2022-07-18T06:53:06.103Z
Guyana,68867,1264,137,0,67603,1.84,Other,2022-07-18T06:53:06.103Z
Haiti,32103,837,33,0,31266,2.61,Other,2022-07-18T06:53:06.103Z
Holy See (Vatican City State),29,0,0,0,29,0.0,Other,2022-07-18T06:53:06.103Z
Honduras,430672,10912,0,0,419760,2.53,Other,2022-07-18T06:53:06.103Z
Hungary,1940824,46696,0,0,1894128,2.41,Western_Europe,2022-07-18T06:53:06.103Z
Iceland,199611,179,0,0,199432,0.09,Western_Europe,2022-07-18T06:53:06.103Z
India,43730071,525660,40082,103,43204411,1.2,Other,2022-07-18T06:53:06.103Z
Indonesia,6134953,156849,7869,16,5978104,2.56,Other,2022-07-18T06:53:06.103Z
"Iran, Islamic Republic of",7278478,141499,8455,22,7136979,1.94,Other,2022-07-18T06:53:06.103Z
Iraq,2405186,25270,5391,7,2379916,1.05,Middle_East,2022-07-18T06:53:06.103Z
Ireland,1628745,7571,0,0,1621174,0.46,Other,2022-07-18T06:53:06.103Z
Israel,4508457,11168,10430,67,4497289,0.25,Middle_East,2022-07-18T06:53:06.103Z
Italy,19985479,169735,206568,239,19815744,0.85,Other,2022-07-18T06:53:06.103Z
Jamaica,144617,3170,128,4,141447,2.19,Other,2022-07-18T06:53:06.103Z
Japan,10102454,31561,201030,64,10070893,0.31,Other,2022-07-18T06:53:06.103Z
Jordan,1702661,14069,0,0,1688592,0.83,Middle_East,2022-07-18T06:53:06.103Z
Kazakhstan,1405908,19020,3037,0,1386888,1.35,Other,2022-07-18T06:53:06.103Z
Kenya,336740,5668,162,0,331072,1.68,Other,2022-07-18T06:53:06.103Z
Kiribati,3236,13,0,0,3223,0.4,Other,2022-07-18T06:53:06.103Z
Korea (North),1,6,0,0,-5,600.0,Other,2022-07-18T06:53:06.103Z
Korea (South),18761757,24742,40342,14,18737015,0.13,Other,2022-07-18T06:53:06.103Z
Kuwait,648216,2556,0,0,645660,0.39,Middle_East,2022-07-18T06:53:06.103Z
Kyrgyzstan,201414,2991,0,0,198423,1.49,Other,2022-07-18T06:53:06.103Z
Lao PDR,210528,757,66,0,209771,0.36,Other,2022-07-18T06:53:06.103Z
Latvia,844980,5875,0,0,839105,0.7,Western_Europe,2022-07-18T06:53:06.103Z
Lebanon,1140794,10489,5229,4,1130305,0.92,Middle_East,2022-07-18T06:53:06.103Z
Lesotho,34040,702,0,0,33338,2.06,Other,2022-07-18T06:53:06.103Z
Liberia,7504,294,0,0,7210,3.92,Other,2022-07-18T06:53:06.103Z
Libya,502289,6430,0,0,495859,1.28,Middle_East,2022-07-18T06:53:06.103Z
Liechtenstein,18335,85,0,0,18250,0.46,Other,2022-07-18T06:53:06.103Z
Lithuania,1169600,9188,1015,0,1160412,0.79,Western_Europe,2022-07-18T06:53:06.103Z
Luxembourg,275512,1103,0,0,274409,0.4,Western_Europe,2022-07-18T06:53:06.103Z
"Macedonia, Republic of",318138,9339,0,0,308799,2.94,Other,2022-07-18T06:53:06.103Z
Madagascar,66098,1403,0,0,64695,2.12,Other,2022-07-18T06:53:06.103Z
Malawi,86900,2652,0,0,84248,3.05,Other,2022-07-18T06:53:06.103Z
Malaysia,4613998,35844,9328,16,4578154,0.78,Other,2022-07-18T06:53:06.103Z
Maldives,183491,307,0,0,183184,0.17,Other,2022-07-18T06:53:06.103Z
Mali,31200,737,4,0,30463,2.36,Other,2022-07-18T06:53:06.103Z
Malta,110967,772,466,4,110195,0.7,Western_Europe,2022-07-18T06:53:06.103Z
Marshall Islands,49,0,0,0,49,0.0,Other,2022-07-18T06:53:06.103Z
Mauritania,61921,986,158,0,60935,1.59,Middle_East,2022-07-18T06:53:06.103Z
Mauritius,233082,1008,0,0,232074,0.43,Other,2022-07-18T06:53:06.103Z
Mexico,6408443,326420,69452,159,6082023,5.09,Other,2022-07-18T06:53:06.103Z
"Micronesia, Federated States of",38,0,0,0,38,0.0,Other,2022-07-18T06:53:06.103Z
Moldova,523034,11584,0,0,511450,2.21,Other,2022-07-18T06:53:06.103Z
Monaco,13739,60,0,0,13679,0.44,Western_Europe,2022-07-18T06:53:06.103Z
Mongolia,930677,2119,0,0,928558,0.23,Other,2022-07-18T06:53:06.103Z
Montenegro,247179,2730,1283,0,244449,1.1,Other,2022-07-18T06:53:06.103Z
Morocco,1251297,16184,2441,11,1235113,1.29,Middle_East,2022-07-18T06:53:06.103Z
Mozambique,229038,2215,66,0,226823,0.97,Other,2022-07-18T06:53:06.103Z
Myanmar,613816,19434,18,0,594382,3.17,Other,2022-07-18T06:53:06.103Z
Namibia,169253,4068,0,0,165185,2.4,Other,2022-07-18T06:53:06.103Z
Nepal,981408,11953,266,1,969455,1.22,Other,2022-07-18T06:53:06.103Z
Netherlands,8274128,22422,13572,9,8251706,0.27,Other,2022-07-18T06:53:06.103Z
New Zealand,1500754,1763,651,21,1498991,0.12,Other,2022-07-18T06:53:06.103Z
Nicaragua,14751,244,0,0,14507,1.65,Other,2022-07-18T06:53:06.103Z
Niger,9096,311,0,0,8785,3.42,Other,2022-07-18T06:53:06.103Z
Nigeria,259007,3144,73,0,255863,1.21,Other,2022-07-18T06:53:06.103Z
Norway,1452668,3504,147,0,1449164,0.24,Western_Europe,2022-07-18T06:53:06.103Z
Oman,391641,4628,0,0,387013,1.18,Other,2022-07-18T06:53:06.103Z
Pakistan,1545647,30438,1516,12,1515209,1.97,Other,2022-07-18T06:53:06.103Z
Palau,5308,6,0,0,5302,0.11,Other,2022-07-18T06:53:06.103Z
Palestinian Territory,662588,5662,0,0,656926,0.85,Other,2022-07-18T06:53:06.103Z
Panama,938791,8386,0,0,930405,0.89,Other,2022-07-18T06:53:06.103Z
Papua New Guinea,44761,662,0,0,44099,1.48,Other,2022-07-18T06:53:06.103Z
Paraguay,688820,19083,0,0,669737,2.77,Other,2022-07-18T06:53:06.103Z
Peru,3729879,213769,26128,38,3516110,5.73,Other,2022-07-18T06:53:06.103Z
Philippines,3733101,60641,5131,0,3672460,1.62,Other,2022-07-18T06:53:06.103Z
Poland,6032475,116470,2528,0,5916005,1.93,Western_Europe,2022-07-18T06:53:06.103Z
Portugal,5273845,24381,0,0,5249464,0.46,Western_Europe,2022-07-18T06:53:06.103Z
Qatar,395051,680,2135,0,394371,0.17,Other,2022-07-18T06:53:06.103Z
Republic of Kosovo,236816,3148,1936,2,233668,1.33,Other,2022-07-18T06:53:06.103Z
Romania,2963934,65813,5883,8,2898121,2.22,Western_Europe,2022-07-18T06:53:06.103Z
Russian Federation,18211383,374062,8598,79,17837321,2.05,Other,2022-07-18T06:53:06.103Z
Rwanda,131857,1464,25,2,130393,1.11,Other,2022-07-18T06:53:06.103Z
Saint Kitts and Nevis,6367,45,0,0,6322,0.71,Other,2022-07-18T06:53:06.103Z
Saint Lucia,27464,385,0,0,27079,1.4,Other,2022-07-18T06:53:06.103Z
Saint Vincent and Grenadines,9183,115,0,0,9068,1.25,Other,2022-07-18T06:53:06.103Z
Samoa,15155,29,0,0,15126,0.19,Other,2022-07-18T06:53:06.103Z
San Marino,19200,116,68,0,19084,0.6,Other,2022-07-18T06:53:06.103Z
Sao Tome and Principe,6079,74,0,0,6005,1.22,Other,2022-07-18T06:53:06.103Z
Saudi Arabia,803764,9232,1178,3,794532,1.15,Other,2022-07-18T06:53:06.103Z
Senegal,86744,1968,65,0,84776,2.27,Other,2022-07-18T06:53:06.103Z
Serbia,2056691,16169,4575,3,2040522,0.79,Other,2022-07-18T06:53:06.103Z
Seychelles,45185,167,0,0,45018,0.37,Other,2022-07-18T06:53:06.103Z
Sierra Leone,7722,125,1,0,7597,1.62,Other,2022-07-18T06:53:06.103Z
Singapore,1596046,1453,16100,6,1594593,0.09,Other,2022-07-18T06:53:06.103Z
Slovakia,2564393,20172,1962,3,2544221,0.79,Western_Europe,2022-07-18T06:53:06.103Z
Slovenia,1060248,6667,2431,1,1053581,0.63,Western_Europe,2022-07-18T06:53:06.103Z
Solomon Islands,21544,153,0,0,21391,0.71,Other,2022-07-18T06:53:06.103Z
Somalia,26900,1361,0,0,25539,5.06,Other,2022-07-18T06:53:06.103Z
South Africa,3999751,101918,1285,23,3897833,2.55,Other,2022-07-18T06:53:06.103Z
South Sudan,17733,138,0,0,17595,0.78,Other,2022-07-18T06:53:06.103Z
Spain,13090476,109348,57635,374,12981128,0.84,Western_Europe,2022-07-18T06:53:06.103Z
Sri Lanka,664448,16528,59,1,647920,2.49,Other,2022-07-18T06:53:06.103Z
Sudan,62795,4955,0,0,57840,7.89,Middle_East,2022-07-18T06:53:06.103Z
Suriname,80919,1377,0,0,79542,1.7,Other,2022-07-18T06:53:06.103Z
Swaziland,73242,1417,7,0,71825,1.93,Other,2022-07-18T06:53:06.103Z
Sweden,2528166,19203,4762,59,2508963,0.76,Western_Europe,2022-07-18T06:53:06.103Z
Switzerland,3861756,13857,0,0,3847899,0.36,Western_Europe,2022-07-18T06:53:06.103Z
Syrian Arab Republic (Syria),55973,3150,0,0,52823,5.63,Other,2022-07-18T06:53:06.103Z
"Taiwan, Republic of China",4264788,8176,49588,145,4256612,0.19,Other,2022-07-18T06:53:06.103Z
Tajikistan,17786,125,0,0,17661,0.7,Other,2022-07-18T06:53:06.103Z
"Tanzania, United Republic of",37510,841,0,0,36669,2.24,Other,2022-07-18T06:53:06.103Z
Thailand,4559029,30996,4053,38,4528033,0.68,Other,2022-07-18T06:53:06.103Z
Timor-Leste,22976,133,0,0,22843,0.58,Other,2022-07-18T06:53:06.103Z
Togo,37798,275,53,0,37523,0.73,Other,2022-07-18T06:53:06.103Z
Tonga,12382,12,0,0,12370,0.1,Other,2022-07-18T06:53:06.103Z
Trinidad and Tobago,169137,4038,109,2,165099,2.39,Other,2022-07-18T06:53:06.103Z
Tunisia,1087030,28823,0,0,1058207,2.65,Middle_East,2022-07-18T06:53:06.103Z
Turkey,15297539,99088,0,0,15198451,0.65,Middle_East,2022-07-18T06:53:06.103Z
Uganda,168724,3627,95,0,165097,2.15,Other,2022-07-18T06:53:06.103Z
Ukraine,5289732,116422,1153,23,5173310,2.2,Other,2022-07-18T06:53:06.103Z
United Arab Emirates,973416,2325,2830,0,971091,0.24,Middle_East,2022-07-18T06:53:06.103Z
United Kingdom,23282710,182262,1840,0,23100448,0.78,Other,2022-07-18T06:53:06.103Z
United States of America,89453076,1023736,303421,912,88429340,1.14,Other,2022-07-18T06:53:06.103Z
Uruguay,965370,7373,0,0,957997,0.76,Other,2022-07-18T06:53:06.103Z
Uzbekistan,242140,1637,97,0,240503,0.68,Other,2022-07-18T06:53:06.103Z
Vanuatu,11722,14,0,0,11708,0.12,Other,2022-07-18T06:53:06.103Z
Venezuela (Bolivarian Republic),529730,5747,346,2,523983,1.08,Other,2022-07-18T06:53:06.103Z
Viet Nam,10760595,43091,1450,1,10717504,0.4,Other,2022-07-18T06:53:06.103Z
Yemen,11848,2149,16,0,9699,18.14,Middle_East,2022-07-18T06:53:06.103Z
Zambia,327994,4009,0,0,323985,1.22,Other,2022-07-18T06:53:06.103Z
Zimbabwe,256083,5566,0,0,250517,2.17,Other,2022-07-18T06:53:06.103Z
